00222222222200222222222200
00222222222200222222222200
22220044444400444444002222
22220044444400444444002222
22220044004400440044002222
22220044004400440044002222
22220044444400440044002222
22220044444400440044002222
22220000004400440044002222
22220000004400440044002222
22220044444400444444002222
22220044444400444444002222
22222222222222222222222222
22222222222222222222222222
55000000000055000000000055
55000000004455440000000055
33000000004444440000000033
33440044004444440044004433
33445544554444445544554433
33445544554444445544554433
33440044004400440044004433
33440044000000000044004433
33440044000000000044004433
33440044000444400044004433
33333300000476400000333333
33333300000466400000333333
