44000000000000000000000000
00000000000000000000000000
44000000111111111111110000
00000000111111111111110000
00440000000000005500110000
00000000000000000000110000
00440000000000005500110000
00000000000000000000110000
00444400000000005500110000
00000000000000000000110000
00004400040000005500110000
00000000040000000000110000
00000000000000000000110000
00000000000000000000110000
00001111111111111100110000
00001111111111111100110000
00001100000000000000000000
00001100000000000000000000
00000000000000000000000000
00000000000000000000000000
00001100000000000000000000
00001100000000000000000000
00001100000000000000000000
00001100000444400000000000
00001111000476400000000000
00001111000466400000000000
